10 10
3 4 3 4 3 4 3 4 3 4 
2 1 1 1 1 1 1 1 1 3
3 0 0 0 0 1 0 0 1 4
4 1 0 1 1 1 1 0 1 3
3 1 0 1 0 0 1 0 0 4 
4 1 1 1 1 0 1 0 0 3
3 1 0 0 0 0 1 1 1 4
4 1 1 0 0 0 0 0 0 3
3 0 1 1 1 1 1 1 1 2
4 3 4 3 4 3 4 3 4 3
